XOXXXX
XOXOOX
XOXOXX
XOOOSX
XXXXXX